NO ./levels/beach/beach_texture_1.xpm
SO ./levels/beach/beach_texture_2.xpm
WE ./levels/beach/beach_texture_3.xpm
EA ./levels/beach/beach_texture_4.xpm
C 0,150,255
F 255,255,200

 11111111111111111111111111111111
 1      1000000000110000000000001
 1      101100000111000000N000001
 1      1001000000000000000000001
111111111011000001110000000000001
100000000011000001110111111111111
11110111111111011100000010001001
11110111111111011101010010001001
11000000110101011100000010001001
10000000000000001100000000000001
10000000000000001101010010001111
11000001110101011111011110N0111
11110111 1110101 101111010001
11111111 1111111 111111111111
