NO ./levels/jungle/jungle_texture_1.xpm
SO ./levels/jungle/jungle_texture_2.xpm
WE ./levels/jungle/jungle_texture_3.xpm
EA ./levels/jungle/jungle_texture_4.xpm

C 153,255,153
F 0,69,5

111111111111111111111
101000000000000100001
100000010000000000001
100000000000100000001
100000000000000000001
101000000000000100001
100000000000000000001
100000000000000000001
100000000000000000001
100000000N00000000001
100000000000000000001
100000000000000000001
101000000000100000001
100000000000000000001
100001000000000000101
100000000000000000001
111111111111111111111
